akin -> hormiga
Alá -> batata
Ami -> !veni¡
amkimin -> no me gusta
An-> Dinero
Atol´ -> gallina
Amkun -> vamos
Atol´pi
Asr-> cuerpo
C´ini kin -> ¿que es ?
ll´i-> pajaro
intak -> plato
is'uk -> mujer
lili-> ellos/ellas
jau-> casa
je -> papa
jauto -> popayan
kalo-> oido
kal'o-> gallo
kalunc'i -> lagartija
kamil -> dedo
kap -> ojos
katsik -> pie
kel iskitik -> zapato
kinkinsisti -> que duerman
kil'i-> cuchara
kis -> olla
kosrejau -> escuela
lus->flauta
muskay-> papá